...#.....S
...#......
...#......
...#......
...#......
...#......
...T......
...T......
...T......
..........