S#.T......
..##....T.
..#.......
..#.......
..#.......
..#.......
..#.......
..#.......
..........
..........