S#........
.#........
.#........
.#........
..........
..........
.........T
..........
..........
..........